[ "SSSSSSSSSSSSSSSSSSSSSSSSSSSSSSSSSSS",
  "Sw---------w----------------------S",
  "Sw---------w----------------------S",
  "Sw---------wwww-------------------S",
  "Sw------w-------------------------S",
  "S-------ww---wwwwwww--------------S",
  "Swww-------wwwwww-----------------S",
  "Swww---wwwww----------------------S",
  "S----www---w---------------------wS",
  "S--------------------------------wS",
  "S--------w----------------www-----S",
  "S------wwwwwwwwwwwww-----wwww-----S",
  "S----------------w----------------S",
  "S----------------w----------------S",
  "S----------------w----------------S",
  "S----------------w----------------S",
  "S---------------------------------S",
  "S---------------------------------S",
  "S---------------------------------S",
  "S---------------------------------S",
  "S---------------------------------S",
  "S---------------------------------S",
  "S---------------------------------S",
  "S---------------------------------S",
  "S---------------------------------S",
  "S---------------------------------S",
  "S---------------------------------S",
  "S---------------------------------S",
  "SSSSSSSSSSSSSSSSSSSSSSSSSSSSSSSSSSS"]