[ "SSSSSSSSSSSSSSSSSSSSSSSSSSSSSSSSSSS",
  "S----------B----------------------S",
  "SB---------B----------------------S",
  "SB---------BBBB-------------------S",
  "SB------B-------------------------S",
  "S-------BB---BBBB-----------------S",
  "SBBB---------BBBB-----------------S",
  "SBBB---BBBBB----------------------S",
  "S----BBB___B---------------------BS",
  "S--------------------------------BS",
  "S--------B----------------BBB-----S",
  "S------BBB---------------BBBB-----S",
  "S----------------B----------------S",
  "S----------------B----------------S",
  "S----------------B----------------S",
  "S----------------B----------------S",
  "S---------------------------------S",
  "S---------------------------------S",
  "S---------------------------------S",
  "S---------------------------------S",
  "S---------------------------------S",
  "S---------------------------------S",
  "S---------------------------------S",
  "S---------------------------------S",
  "S---------------------------------S",
  "S---------------------------------S",
  "S---------------------------------S",
  "S---------------------------------S",
  "SSSSSSSSSSSSSSSSSSSSSSSSSSSSSSSSSSS"]