["WWWWWWWWWWWWWWWWWWWW",
"W----------W-------W",
"WW---------W-------W",
"WW---------WWWW----W",
"WW------W----------W",
"W-------WW---WWWW--W",
"WWWW---------WWWW--W",
"WWWW---WWWWW-------W",
"W----WWW___W------WW",
"W-----------------WW",
"W--------W------WWWW",
"W------WWW-----WWWWW",
"W------W-----------W",
"WWWWWWWWWWWWWWWWWWWW"]