["BBBBBBBBBBBBBBBBBBBB",
"B----------B-------B",
"BB---------B-------B",
"BB---------BBBB----B",
"BB------B----------B",
"B-------BB---BBBB--B",
"BBBB---------BBBB--B",
"BBBB---BBBBB-------B",
"B----BBB___B------BB",
"B-----------------BB",
"B--------B------BBBB",
"B------BBB-----BBBBB",
"B------B-----------B",
"BBBBBBBBBBBBBBBBBBBB"]