[ "SSSSSSSSSSSSSSSSSSSSSSSSSSSSSSSSSSS",
  "S---------------------------------SS",
  "S-rrrrrrrrrrrrrd------------------SS",
  "S--------------d-----------d------SS",
  "S--------------d-----------d------SS",
  "S--------rrrrrrd-----------d------SS",
  "S--------------drrrrrrrrrrrd------SS",
  "S--------------d------------------SS",
  "S-------------dd------------------SS",
  "S---------rrrrd-------------------SS",
  "S-------------d-------------------SS",
  "S-------------d-------------------SS",
  "S-------------d-------------------SS",
  "S----------rrrdrrrrrrr------------SS",
  "S-------------------d-------------SS",
  "S-------------------d-------------SS",
  "S-------------------d-------------SS",
  "S------------rrrrrrrd-------------SS",
  "S-------------------d-------------SS",
  "S-------------------d-------------SS",
  "S---------------------------------SS",
  "S---------------------------------SS",
  "S---------------------------------SS",
  "S---------------------------------SS",
  "S---------------------------------SS",
  "S---------------------------------SS",
  "S---------------------------------SS",
  "S---------------------------------SS",
  "S---------------------------------SS",
  "S---------------------------------SS",
  "S---------------------------------SS",
  "S---------------------------------SS",
  "SSSSSSSSSSSSSSSSSSSSSSSSSSSSSSSSSSSS"
]