["SSSSSSSSSSSSSSSSSSSS",
"S----------B-------S",
"SB---------B-------S",
"SB---------BBBB----S",
"SB------B----------S",
"S-------BB---BBBB--S",
"SBBB---------BBBB--S",
"SBBB---BBBBB-------S",
"S----BBB___B------BS",
"S-----------------BS",
"S--------B------BBBS",
"S------BBB-----BBBBS",
"S------B-----------S",
  "SSSSSSSSSSSSSSSSSSSS"]