[ "SSSSSSSSSSSSSSSSSSSSSSSSSSSSSSSSSSS",
  "Sw---------w----------------------S",
  "Sw---------w----------------------S",
  "Sw---------wwww-------------------S",
  "Sw------w-------------------------S",
  "S-------ww---wwww-----------------S",
  "Swww---------wwww-----------------S",
  "Swww---wwwww----------------------S",
  "S----www___w---------------------wS",
  "S--------------------------------wS",
  "S--------w----------------www-----S",
  "S------www---------------wwww-----S",
  "S----------------w----------------S",
  "S----------------w----------------S",
  "S----------------w----------------S",
  "S----------------w----------------S",
  "S---------------------------------S",
  "S---------------------------------S",
  "S---------------------------------S",
  "S---------------------------------S",
  "S---------------------------------S",
  "S---------------------------------S",
  "S---------------------------------S",
  "S---------------------------------S",
  "S---------------------------------S",
  "S---------------------------------S",
  "S---------------------------------S",
  "S---------------------------------S",
  "SSSSSSSSSSSSSSSSSSSSSSSSSSSSSSSSSSS"]