[ "SSSSSSSSSSSSSSSSSSSSSSSSSSSSSSSSSS",
  "Sw---------w------------------S",
  "Sw---------w------------------S",
  "Sw---------wwww---------------S",
  "Sw------w---------------------S",
  "S-------ww---wwww-------------S",
  "Swww-------wwwwww-------------S",
  "Swww---wwwww------------------S",
  "S----www---w------------------S",
  "S-----------------------------S",
  "S--------w-------------www----S",
  "S------www------------wwww----S",
  "S----------------w------------S",
  "S-------------w---------------S",
  "S-------------w---------------S",
  "S-------------w---------------S",
  "S-----------------------------S",
  "S-----------------------------S",
  "S-----------------------------S",
  "S-----------------------------S",
  "S-----------------------------S",
  "S-----------------------------S",
  "S-----------------------------S",
  "S-----------------------------S",
  "S-----------------------------S",
  "S-----------------------------S",
  "S-----------------------------S",
  "S-----------------------------S",
  "SSSSSSSSSSSSSSSSSSSSSSSSSSSSSSSSSS"]