[ "SSSSSSSSSSSSSSSSSSSSSSSSSSSSSSSSSSS",
  "S---------------------------------S",
  "S-rrrrrrrrrrrrrd------------------S",
  "S--------------d-----------d------S",
  "S--------------d-----------d------S",
  "S--------rrrrrrd-----------d------S",
  "S--------------drrrrrrrrrrrd------S",
  "S--------------d------------------S",
  "S-------------dd------------------S",
  "S---------rrrrd-------------------S",
  "S-------------d-------------------S",
  "S-------------d-------------------S",
  "S-------------d-------------------S",
  "S----------rrrdrrrrrrr------------S",
  "S-------------------d-------------S",
  "S-------------------d-------------S",
  "S-------------------d-------------S",
  "S------------rrrrrrrd-------------S",
  "S-------------------d-------------S",
  "S-------rrrrrrrrrrrrd-------------S",
  "S---------d-----------------------S",
  "S---------d-----------------------S",
  "S---------d-----------------------S",
  "S---------d-----------------------S",
  "S---------d-----------------------S",
  "S---------d-----------------------S",
  "S---------drrrrrrrrrrrrrrrrrrrrr--S",
  "S---------------------------------S",
  "S---------------------------------S",
  "S---------------------------------S",
  "S---------------------------------S",
  "S---------------------------------S",
  "SSSSSSSSSSSSSSSSSSSSSSSSSSSSSSSSSSS"
]