                 ["W_WWWWWWWWWWWWWWWWWW",
                  "W__WWWWWWWWWWWWWWWWW",
                  "WW__----WWWWWWWWWWWW",
                  "WWWWWWW-WWWWWWWWWWWW",
                  "WWWWWWW-W---WWWWWWWW",
                  "WWWWWWW---W__WWWWWWW",
                  "WWWWWWWWWWWW-WWWWWWW",
                  "WWWWWWWWWWWW---___WW",
                  "WWWWWWWW___WWWWWW-WW",
                  "WWWWWWWW-W--------WW",
                  "WWWWWWWW-WWWWWWWWWWW",
                  "---------WWWWWWWWWWW",
                  "WWWWWWWWWWWWWWWWWWWW",
                  "WWWWWWWWWWWWWWWWWWWW"]